|||||||||||||||||||||||||||||||||||||
|||||||||||||||||||||||||||||||||||||
||                                P||
|| ||||||||      |||||||| |||||||  ||
|| ||   |   |      ||||||   ||     ||
|| || | | | | |||| |||||||| || ||||||
|| || | | | |             || ||    ||
|| || | | | | | ||||  |||    ||||| ||
|| |  | | |   |    || |||||||      ||
|| || | | ||||||| ||        || ||||||
|| ||   ||       ||||||||| ||      ||
||    ||||| |||||||      || |||||  ||
|||||||      |       |||| ||       ||
||      ||||| |||||| |    || ||||||||
|| ||||||      |       ||||| ||    ||
||        ||||| ||||||||||| ||  || ||
|||||||||||                  ||||| ||
||.         ||||||||||||||         ||
|||||||||||||||||||||||||||||||||||||
|||||||||||||||||||||||||||||||||||||